111111111111111111111111111111111111111111111111111111111111
1P0000000111111111110000000000000000000000001111111111111111
111111101111111111111111111111111111111111000111111111111111
100000101000000000000000000011111111111111000111111111111111
101111101011111111111111111011111111111111000111111111111111
100000001011111111111111111011111111111111000000000000111111
111111101011111111111111111011111111111111111111111000111111
100000001000000000000111111000000000000000000000011000111111
101111111111111111100111111011111111111111111000011111111111
100000000000000000000111111000000000000000011000011111111111
111111111111111111100111111011111111111111011000011111111111
111111111111111111100000000011111111111111000000011111111111
111111111111111111111111101111111111111111111111111111111111
111111111111111111111111101111111111111111111111111111111111
100000000011111111111111100000000000000000000000000000000011
101111111011111111111111111111111111111111111111111111111011
100000001000000000000111111111111111111111111111111111111011
111111101111111111100111111111111111111111111111111111111011
111111100000000011100111111111111111111111111111111111111011
111111111111111011100111111111111111111111111111111111111011
111111111111111000100000000000000000000000000000000000000011
111111111111111111111111111111111111111111111111111111111011
100000000000111111111111111111111111111111111111111111111011
101111111111111111111111111111111111111111111111111111111011
100000000000000000000000000000000000000000000000000000000011
111111111111111111111111111111111111111111111111111111111011
1ECCCCCCCCCCCCCCCCCCCCCCCCCCCCCCCCCCCCCCCCCCCCCCCCCCCCCC0C11
111111111111111111111111111111111111111111111111111111111111
