9.ox
...........oo..............
............o.oo......o....
.......................o...
..........o.........o......
...........................
...................o......o
............o.....o........
.........................o......oo...........o........
